TW4
25 16
*************************
*                       *
*                       *
*                       *
*                       *
*                       *
*                       *
*          *            *
*          *            *
*          *            *
*    B     *     +      *
*          *            *
*          *            *
*                       *
*                       *
*************************
