TW14
25 16
*************************
*                       *
*                       *
*                       *
*                       *
*                       *
*                 @     *
*         +@     @ @    *
*         @     @ B @   *
*              @    @@  *
*               @@@T @  *
*                  @@   *
*                       *
*                       *
*                       *
*************************
