TW21
25 16
*************************
*K          #           *
*           *           *
*           *           *
*           *           *
*           *           *
*           *           *
*           *           *
*           *           *
*           *           *
*           *           *
*           *           *
*           *           *
*           *           *
*          B*+          *
*************************
