TW23
25 16
*************************
*                       *
*                       *
*                       *
*                       *
*                       *
*                       *
*         QQ            *
*         QQ            *
*         QQ            *
*    B    QQ     +      *
*         QQ            *
*         QQ            *
*                       *
*                       *
*************************
