TW25
25 16
*************************
*                       *
*                       *
*                       *
*                       *
*                       *
*                       *
*                       *
*         QQ            *
*        QQQQ           *
*    B   QQQQQQ+        *
*        QQQQ           *
*         QQ            *
*                       *
*                       *
*************************
