TW30
25 16
*************************
*****QQQQQQQQQQQQQQQQQQQ*
***** ** ********** *****
*****B   ********** *****
****** ******** *** *****
* **** ******** *** *****
* ****          *** *****
* ***QQQQ QQQQQ *** *****
* QQQQQQQQQQQQQ *** *****
* **         ** *** *****
* ** **** ***** *** *****
* ** **** *****     *****
*         *********Q*****
***********         *****
*******************+*****
*************************
