TW1
25 16
*************************
*                       *
*                       *
*    B                  *
*                       *
*                       *
*                       *
*                       *
*                 +     *
*                       *
*                       *
*                       *
*                       *
*                       *
*                       *
*************************
