TW2
25 16
*************************
*                       *
*                       *
*                       *
*                       *
*                       *
*     B          QQQ    *
*               QQQQQ   *
*              QQQ +Q   *
*              QQ    Q  *
*               QQQ  Q  *
*                  QQ   *
*                       *
*                       *
*                       *
*************************
