TW5
25 16
*************************
*                       *
*                       *
*      T                *
*                       *
*                       *
*                @@     *
*               @@@@    *
*              @@ + @   *
*              @     @  *
*               @@@  @  *
*                  @@   *
*       B               *
*                       *
*                       *
*************************
