TW11
25 16
*************************
*              =        *
*  B           =        *
*     T K      =        *
*===============        *
*                       *
*                       *
*                       *
*                       *
*                       *
*             *#########*
*             #         *
*    K        #         *
*             #      +  *
*             #         *
*************************
