TW12
25 16
*************************
*              =        *
*  B           =        *
*     K T      =        *
*===============        *
*                       *
*                       *
*                       *
*                       *
*                       *
*              @@@@@@@@@*
*            @@         *
*    T       @          *
*            @       +  *
*           @@          *
*************************
