TW13
25 16
*************************
*              *        *
*  B           *        *
*     T K      *        *
**************=*        *
*                       *
*                       *
*                       *
*        ****************
*        *    +      =  *
*        *           =  *
*        *           *  *
*        *           *  *
*        *************  *
*            K      T   *
*************************
