TW21
25 16
*************************
*   ##                  *
*  #K #                 *
* #    #                *
* #     #       *********
*  # B  #       *       *
*   ####        *QQQQQQQ*
*               * + QQQQ*
*              *****QQQQ*
*              *   QQQQQ*
*              *        *
*              *        *
*              *******  *
*                    *  *
*                       *
*************************
