TW22
25 16
*************************
*  @@@@                 *
*  @T @                 *
* @@   @@               *
* @     @       *********
*  @ B  @       *       *
*   @@@@        *QQQQQQQ*
*               * + QQQQ*
*              *****QQQQ*
*              *   QQQQQ*
*              *        *
*              *        *
*              *******  *
*                    *  *
*                       *
*************************
