TW23
25 16
*************************
*      T @              *
* B      @              *
*    @@@@               *
*@@@@@                  *
*       K   ============*
*           =           *
*           =           *
*           =     *#####*
*============     #     *
*                 #   + *
*                 #     *
*                 *#####*
*    K                  *
*                       *
*************************
