TW25
25 16
*************************
*           *           *
*           *           *
*           *           *
*           *           *
*           *           *
*        B  * +         *
*         T *           *
*           *****@*******
*           *           *
*           *           *
*           *           *
*           *       T   *
*           =           *
*           *           *
*************************
