TW27
25 16
*************************
*      B     #          *
* K       ###      T    *
*        #              *
*********@@@@@@@@@@@    *
*                  @    *
************=======******
*                       *
*                       *
*                       *
*                 QQQQ  *
*             QQQ Q     *
*             Q QQQQQQQQ*
*             Q QQQ+QQQQ*
*               QQQQQQQQ*
*************************
