TW3
25 16
*************************
*          =            *
*          =            *
*    B K   =            *
*      T   =            *
*          =            *
*          =            *
*          =            *
*          =      +     *
*          =            *
*          =            *
*          =            *
*          =            *
*          =            *
*          =            *
*************************
