TW4
25 16
*************************
*           #           *
*  K        #           *
*           #           *
*           #           *
*           #           *
*           #           *
*           #           *
*           #           *
*           #           *
*           #           *
*           #           *
*    B      #           *
*           #         + *
*           #           *
*************************
