TW6
25 16
*************************
*               *       *
*               *       *
*   *************       *
*   *           *       *
*   *     *******       *
*   *                   *
*   *                   *
*   *     *******       *
*   *           *       *
*   *        +  *       *
*   *************       *
*                       *
*   B                   *
*                       *
*************************
