TW7
25 16
*************************
*        B              *
*        KT             *
*                       *
*                       *
*                       *
*                       *
*=======================*
*                       *
*                       *
*                 QQQQ  *
*             QQQ Q     *
*             Q QQQQQQQQ*
*             Q QQQ+QQQQ*
*               QQQQQQQQ*
*************************
