TW8
25 16
*************************
*                       *
*     B                 *
*                  K    *
*                       *
*                       *
*#######################*
*                       *
*                       *
*                 QQQQ  *
*                 Q     *
*             QQQQQQQQQQ*
*             Q QQQ+QQQQ*
*             Q QQQQQQQQ*
*               QQQQQQQQ*
*************************
