TW9
25 16
*************************
*                       *
*     B                 *
*                  T    *
*                       *
*                       *
*@@@@@@@@@@@@@@@@@@@@@@@*
*                       *
*                       *
*                 QQQQ  *
*                 Q     *
*             QQQQQQQQQQ*
*             Q QQQ+QQQQ*
*             Q QQQQQQQQ*
*               QQQQQQQQ*
*************************
