TW10
25 16
*************************
*                       *
*                       *
*                       *
*            *********QQ*
*            *      QQQQ*
*            *      QQQQ*
*            *      QQQQ*
*            *          *
*            *QQQQQ     *
*            *QQQQQ     *
*            *+ QQQ     *
*   B        ************
*                       *
*                       *
*************************
