TW14
25 16
*************************
*  @@@@                 *
*  @T @                 *
* @@   @@               *
* @     @               *
*  @ B  @               *
*   @@@@                *
*                       *
*                 #     *
*                # #    *
*               # + #   *
*              #     #  *
*    K          ###  #  *
*                  ##   *
*                       *
*************************
