TW17
25 16
*************************
*           B           *
*      K                *
*                       *
**********#####**********
*                       *
*         KKKKK         *
*=======================*
*                       *
*                       *
*                 QQQQ  *
*             QQQ Q     *
*             Q QQQQQQQQ*
*             Q QQQ+QQQQ*
*               QQQQQQQQ*
*************************
