TW18
25 16
*************************
*           B           *
*      T                *
*                       *
*********@@@@@@**********
*                       *
*                       *
*=======================*
*                       *
*                       *
*                 QQQQ  *
*             QQQ Q     *
*             Q QQQQQQQQ*
*             Q QQQ+QQQQ*
*               QQQQQQQQ*
*************************
