TW19
25 16
*************************
*              K        *
*              *******  *
*      *********      T *
* B T  *                *
*  K   *                *
*    *****=**************
*    *QQQQQQQQQQ        *
*    *QQQQQQQQQQ        *
*    *QQQQQQQ+ Q        *
*    *QQQQ QQ  Q        *
*    *QQQQ QQ           *
*    *QQQQQQQ           *
******                  *
*                       *
*************************
