TW20
25 16
*************************
*  @@@@                 *
*  @T @                 *
* @@   @@         K     *
* @     @               *
*  @ B  @               *
*   @@@@           QQQQQ*
*                QQQQQQQ*
*               QQ      *
*              QQ##     *
*            QQQ#+ #    *
*          QQQQ#    #   *
*        QQQQ  #    #   *
*        QQ     ####    *
*        QQ             *
*************************
