TW30
25 16
*************************
*                 *     *
*                 @QQQ  *
*          ********QQQQ *
*                 *QQ+Q *
*                 *QQQQ *
*                 *     *
*                 *******
**********              *
*  K     *              *
*        *              *
*        *              *
*        #         T    *
*        *              *
*B       *              *
*************************
