TW31
25 16
*************************
*                 *     *
*                 *     *
*                 @   + *
*                 *     *
*        ****************
*                       *
*                       *
*                       *
*                       *
****=*****              *
*        *              *
*        #         K    *
*        *              *
*BT      *              *
*************************
