TW32
25 16
*************************
*                 *     *
*                 @QQQ  *
*          ********QQQQ *
*                 *QQ+Q *
*                 *QQQQ *
*                 *     *
*                 *******
*                       *
*                       *
****=*****              *
*        *              *
*        #         K    *
*        *              *
*BT      *              *
*************************
