Demo World
14 11
**************
*       *    *
* K     @  + *
*       *    *
*       ******
*            *
***=**       *
*    *       *
*    #   B   *
* T  *       *
**************
