TW2
25 16
*************************
*                       *
*                       *
*                       *
*                       *
*  *****           ******
*  *   *************    *
*  * B *              QQ*
*  *      * **********QQ*
*  *****QQ*QQQQ       QQ*
*      *QQ*QQQQ       QQ*
*      *QQ*QQQ        QQ*
*      ** *     +     QQ*
*       * *           QQ*
*       * *             *
*************************
