TW9
25 16
*************************
*           @           *
*  T        @           *
*           @           *
*           @           *
*           @           *
*           @           *
*           @           *
*    B      @           *
*           @           *
*           @           *
*           @           *
*           @           *
*           @         + *
*           @           *
*************************
