TW10
25 16
*************************
*           *           *
*           *           *
*           *           *
*           *           *
*           *           *
*           *           *
*           *           *
*        B  * +         *
*         T *           *
*           *           *
*           *           *
*           *           *
*           @           *
*           @           *
*************************
