TW15
25 16
*************************
*           #           *
*           #           *
*           #           *
*           #           *
*           #           *
*           #           *
*           #           *
*        B  # +         *
*         K #           *
*           #           *
*           #           *
*           #           *
*           #           *
*           #           *
*************************
