TW18
25 16
*************************
*           *           *
*           *           *
*           *           *
*           *           *
*           *           *
*           *           *
*           *           *
*        B  * +         *
*         K *           *
*           *           *
*           *           *
*           *           *
*           #           *
*           #           *
*************************
