TW32
25 16
*************************
*           *           *
*           *           *
*           *           *
*           *           *
*           *           *
*           =           *
*           *           *
*    B      *           *
*        K  *           *
*           *      +    *
*           *           *
*           *           *
*           *           *
*           *           *
*************************
