TW35
25 16
*************************
*           *           *
*           *           *
*           *           *
*           *           *
*           *           *
*        B  * +         *
*         T *           *
*           *****@*******
*           *           *
*           *           *
*           *           *
*           *           *
*           =           *
*           *          T*
*************************
