TW41
26 14
**************************
*              *         *
*              *         *
*              #         *
*              *         *
*              *         *
*              *         *
*       K      *         *
*              *    +    *
*              *         *
*  B           *         *
*              *         *
*              *         *
**************************
