TW49
25 16
*************************
*                 *     *
*                 *     *
*                 @   + *
*                 *     *
*                 *******
*                       *
*                       *
*                       *
*                       *
****=*****              *
*        *              *
*        #         K    *
*        *              *
*BT      *              *
*************************
