Demo World
14 11
**************
*       *    *
* K  T  R  + *
*       *    *
*       ******
*            *
***=******@***
* B  * T     *
*    #       *
* G  *       *
**************
