TW1
25 16
*************************
*                       *
*                       *
* QQQ                   *
* QQQ    G              *
* QQQ                   *
*     $                 *
* $           K         *
*    B                  *
*  $                    *
*    T ***R**           *
*      @    #           *
*      *  + *           *
*      ******           *
*                       *
*************************
