TW1
25 16
*************************
*                       *
*                       *
*                       *
*                       *
*                       *
*                       *
*             K         *
*    B +                *
*                       *
*                       *
*                       *
*                       *
*                       *
*                       *
*************************
