TW2
25 16
*************************
*                       *
*                       *
*                       *
*                       *
*                       *
*                       *
*                       *
*                       *
*                       *
*    B           +      *
*                       *
*                       *
*                       *
*                       *
*************************
