TW7
25 16
*************************
*           @           *
*           @           *
*           @           *
*           @           *
*           @           *
*           @           *
*           @           *
*        B  @ +         *
*         T @           *
*           @           *
*           @           *
*           @           *
*           @           *
*           @           *
*************************
