TW8
25 16
*************************
*           @           *
*           @           *
*           @           *
*           @           *
*           @           *
*           @           *
*           @           *
*    B      @           *
*        T  @           *
*           @      +    *
*           @           *
*           @           *
*           @           *
*           @           *
*************************
