TW12
25 16
*************************
*B          @           *
*           *           *
*           *           *
*           *           *
*           *           *
*           *           *
*           *           *
*           *           *
*           *           *
*           *           *
*           *           *
*           *           *
*           *           *
*T          *          +*
*************************
