TW13
25 16
*************************
*T          @           *
*           *           *
*           *           *
*           *           *
*           *           *
*           *           *
*           *           *
*           *           *
*           *           *
*           *           *
*           *           *
*           *           *
*           *           *
*          B*+          *
*************************
