TW19
25 16
*************************
*           *           *
*           *           *
*           *           *
*           *           *
*           *           *
*           *           *
*           *           *
*    B      *           *
*        K  *           *
*           *      +    *
*           *           *
*           *           *
*           *           *
*           #           *
*************************
