TW20
25 16
*************************
*B          #           *
*           *           *
*           *           *
*           *           *
*           *           *
*           *           *
*           *           *
*           *           *
*           *           *
*           *           *
*           *           *
*           *           *
*           *           *
*K          *          +*
*************************
