TW24
25 16
*************************
*                       *
*                       *
*                       *
*                       *
*                       *
*                       *
*                       *
*                       *
*                       *
*    B   Q  +           *
*                       *
*                       *
*                       *
*                       *
*************************
