TW26
25 16
*************************
*  *   **        *    B *
*   *       * *      *  *
*      *    *   *  *    *
*   *     * *          **
*      *       *   *    *
*  *       *     *    * *
*  **  **     *  *      *
**         *         *  *
*    *  *  ** *     *   *
*   *            *      *
*      *   *       *  * *
*  *      +*   *        *
*       * *       *  *  *
* * *        *          *
*************************
