TW29
25 16
*************************
*****         ***** *****
***** ** ********** *****
*****B   ********** *****
****** ******** *** *****
* **** ******** *** *****
* ****          *** *****
* ******* ***** *** *****
* ******* ***** *** *****
* **         ** *** *****
* ** **** ***** *** *****
* ** **** *****     *****
*         ********* *****
***********         *****
*******************+*****
*************************
