TW34
25 16
*************************
*           *           *
*           *           *
*           *           *
*           *           *
*           *           *
*           *           *
*           *           *
*        B  *      +    *
*         T *           *
*           ******=******
*           *           *
*           *           *
*           *           *
*           @           *
*************************
