TW50
25 18
*************************
*        B @ T          *
*      QQQQQQ           *
*      QQQQQQ           *
** ** @QQQQKQ           *
*      QQQQQQ           *
*      QQQQQQ           *
*          @            *
*                       *
********#****************
*                       *
*                       *
*                       *
*                       *
*                       *
*         +             *
*                       *
*************************
