TW22
25 16
*************************
*                       *
*                       *
*                       *
*                       *
*                       *
*                 #     *
*                # #    *
*    B          # + #   *
*              #     #  *
*     K         ###  #  *
*                  ##   *
*                       *
*                       *
*                       *
*************************
