TW33
25 16
*************************
*  K   KK        K    B *
*   K       K K      K  *
************=************
*   K     K K  *       K*
*      K       *   K    *
*  K       K   * K    K *
*  KK  KK ****** K      *
*K        *K         K  *
*    K  K *KK K     K   *
*   K     =      K      *
*      K  *K       K  K *
*  K      *K   K        *
*       K *       K  K  *
* K K     *+ K          *
*************************
