TW35
25 16
*************************
*           *           *
*           *           *
*           *           *
*           *           *
*           *           *
*        B  * +         *
*         K *           *
*           *****#*******
*           *           *
*           *           *
*           *           *
*           *           *
*           =           *
*           *          K*
*************************
